type octile
height 34
width 123
map
@@@@@@@@@@@@@@@@@@@@@@@@@@@@@@@@@@@@@@@@@@@@@@@@@@@@@@@@@@@@@@@@@@@@@@@@@@@@@@@@@@@@@@@@@@@@@@@@@@@@@@@@@@@@@@@@@@@@@@@@@@
@...........................................@...........................................@................................@
@...........................................@...........................................@................................@
@...........................................@...........................................@................................@
@...........................................@...........................................@................................@
@...........................................@...........................................@................................@
@...........................................@...........................................@................................@
@...........................................@...........................................@................................@
@...........................................@...........................................@................................@
@...........................................@...........................................@................................@
@...........................................@...........................................@................................@
@@@@@@@@@@@@@@@@@@@@@@@@@@@@@@@@@@..........@..........@..........@..........@@@@@@@@@@@@..........@@@@@@@@@@@@..........@
@...........................................@..........@..........@...........................................@..........@
@...........................................@..........@..........@...........................................@..........@
@...........................................@..........@..........@...........................................@..........@
@...........................................@..........@..........@...........................................@..........@
@...........................................@..........@..........@...........................................@..........@
@...........................................@..........@..........@...........................................@..........@
@...........................................@..........@..........@...........................................@..........@
@...........................................@..........@..........@...........................................@..........@
@...........................................@..........@..........@...........................................@..........@
@...........................................@..........@..........@...........................................@..........@
@..........@@@@@@@@@@@@@@@@@@@@@@@@@@@@@@@@@@..........@@@@@@@@@@@@@@@@@@@@@@@..........@@@@@@@@@@@@@@@@@@@@@@@..........@
@......................................................@..........@.....................@.....................@..........@
@......................................................@..........@.....................@.....................@..........@
@......................................................@..........@.....................@.....................@..........@
@......................................................@..........@.....................@.....................@..........@
@......................................................@..........@.....................@.....................@..........@
@......................................................@..........@.....................@.....................@..........@
@......................................................@..........@.....................@.....................@..........@
@......................................................@..........@.....................@.....................@..........@
@......................................................@..........@.....................@.....................@..........@
@......................................................@..........@.....................@.....................@..........@
@@@@@@@@@@@@@@@@@@@@@@@@@@@@@@@@@@@@@@@@@@@@@@@@@@@@@@@@@@@@@@@@@@@@@@@@@@@@@@@@@@@@@@@@@@@@@@@@@@@@@@@@@@@@@@@@@@@@@@@@@@